# # # # # # ##########
## ### ### ###########
### ### ### ###########
# # # # # # # # # # # #
### ### ### ### ### ###
